+--+--+--+--+
|     |     |
+  +  +  +  +
|  |  |  |  |
+  +  +--+  +
|  |        |
+  +--+  +--+
|     |    g|
+--+--+--+--+
